akan  - difficult, complicated, irrational
akesi - reptile, amphibian, slimy thing
alasa  - to hunt, search, find, gather
ale  - divine, sacred, beyond
ali  - all, every, full, infinite               
amini  - to trust, believe in, expect
anomi - bored, annoyed, sarcastic, angsty            
anpa - below, bottom
ante - different, other
anu - or, minus, intersection, minimum
apeja - guilty, ashamed, embarrased
asite - acid, vinegar, coffee 
awase  - to bump, knock, jolt
awen - continuing, present, stay, constant
ekon   - to go, travel
en - and, plus, union, maximum     
enko - distance, depth, volume    
esun - market, shop, business
fansi - fancy, honorable
ijo - thing, event, object, matter, something, stuff
ike - bad, evil, wrong
ilema  - to feel, touch 
ilo - tool, machine, device, technology
insa - inside, between, centered
ipa  - part, portion, segment, some
jaki - dirty, gross, disgusting, sick, infected
jami - awesome, cool, goes hard, yummy
jan - human, person, someone, anyone
jelo - yellow
jeno - place, position, level, status, reputation
jo     - to have, contain, own, control
kala - sea creature, fish
kalama - sound, noise, tone
kama - coming, future, eventual
kapesi - grey, brown
kasi - plant, leaf, vegetation
kemu - rubber, plastic, silicon
ken - may, can, to be able to 
kepen  - to use, wield
ki  - 5            
kiki - sharp, pointy
kili - fruitgetable
kine - important, powerful, influential
kipi   - to cut, slice, split, divide
kiwen - metal, rock, stone
ko - clay, dough, goop, sand
kon - air, essence, spirit, gas, oxygen, smell
konwe - animacy, life, existence
kosan  - to protect, guard, defend
kule - colorful
kulupu - group, community, society, organization
kuntu - humor, comedy, laughter
kute - to hear, obey, listen
lakana - to put, bring, set down
lanpan - to get, receive, acquire, remember, choose
lape   - sleeping, resting
laso - blue
lawa - head, mind, leader, plan
leko - square, corner, block
len - cloth, fabric, textile, clothing
lete   - cold, raw, bleak                
lili   - small, short, young 
linja - long and flexible thing, cord, hair, rope, thread
lipu - flat object, book, card, paper, website, record
lo  - 0, none, empty                  
loje - red
lon  - true, on, at, in
luji   - to allow, permit, let
luka - hand, arm
lukin - to see, look, observe, read
lupa - hole, orifice, door, window
ma - earth, land, dirt, country, zone 
majuna - old, aged, experienced
mama - parent, ancestor, caretaker
mani - money, savings, wealth, gold, rare metal
meli - female
meso - normal, regular, average
mi - I, me, we, us
mije - male
moku - to eat, drink, ingest
moli   - dead, dying
monsi - back, behind
monsuta - fear, dread, danger, monster, anxiety
mun -n
mute - many
naja - sky, e, universe
namako - salt, powder, embellishment, spice, sugar              
nanpa - number, ordinal suffix
nasa  - strange, unusual, inebriated, indeterminate
nasara - theory, guess, hypothesis, opinion 
nasin - way, custom, path, method
nena - bump, hill, mountain, nose, protuberance
ni - this, that            
nimi - name, word, statement, quote
noka - foot, leg
ojele - oil, soap, gel, gasoline, wax
oko - eye
olin   - to love, respect
ona - he, she, it, they   
open - to begin, start, open
pake - to stop, prevent, end, close
palaka - broken, botched, damaged
pali - to do, make, work on, try, attempt
palisa - long hard thing, stick, branch
pan - bread,in, rice, pasta
pana   - done, completed, finished
pana   - to give, send, emit, pay, help
pata - brother, sibling
peta - green
peto - sad, depressed          
pika - electricity
pilin - heart, personal emotional state 
pimeja - black
pipi - bug, germ, insect, minor annoyance
po  - 4            
poka - in front of, next to, beside
poki - container, bag, cup, list, set
pona - good, nice, right, ethical 
powe - false, pseudo, imposter
puwa - soft, cuddly
sa  - 3            
sama - same, similar
santo - ear
seli - fire, heat source, cooking element
selo - outer form, peel, shell, skin, boundary
sewi - above, top
sijelo - body, torso, state, self
sike - circle, round thing, ball, wheel, cycle
sin    - new, fresh, young 
sina - you 
sinpin - face
sitelen - image, picture, representation, writing, symbol
soja - happy, excited
soko - mushr fungus, network
sona - to know
soto - right
soweli - animal, beast, land mammal
suli   - big, heavy, tall
suno - sun, , light, light source               
supa - horizontal surface, floor, table
suwi  - sweet, innocent, adorable
taki   - sticky, magnetic, attractive
tan  - by, from, times, because of, x tan y -> if y then x
taso - but, however                 
tawa - toward, past, for
teje - left
tenpo - time, moment, period, duration
tokana - to focus, concentrate, consider
toki   - to say, communicate
tomo - house, home, room, indoor space
tonsi - non-binary, androgynous
tu  - 2            
unpa - to fuck, have sex with
usawi - magic, ghost
uta - mouth, lips, teeth
utala - to fight, battle, challenge, compete
waleja - context, background, reason, purpose
walo - white
wan - 1
waso - bird, winged creature, flying thing 
wawa   - strong, powerful, confident
weka   - absent, away, ignored
wile   - to want, desire, need